. . . . . x . . . 6
. x x x . x . x x .
. . . x . . . x . .
x x . x x x . x . .
* . . . . . . . . .
